{
  "b": "b",
  "p": "p",
  "m": "m",
  "f": "f",
  "d": "d",
  "t": "t",
  "n": "n",
  "l": "l",
  "g": "g",
  "k": "k",
  "h": "h",
  "j": "j",
  "q": "q",
  "x": "x",
  "zh": "zh",
  "ch": "ch",
  "sh": "sh",
  "r": "r",
  "z": "z",
  "c": "c",
  "s": "s",
  "w": "w",
  "y": "y",
  "'": "'"
}